00000000000000000000000000000000000000000000000000
00000000000000000000000000000000000000000000000000
00000000000000000000000000000000000000000000000000
00000000000000000000000000000000000000000000000000
00000000000000000000000000000000000000000000000000
00000000000000000000000000000000000000000000000000
00000000000000000000000000000000000000000000000000
00000000000000000000000000000000000000000000000000
00000000000000000000000000000000000000000000000000
00000110000000000000000000000000000000000000000000
00000110000000000000000000000000000000110000000000
00000000000000000000000000000000000011111100000000
00000000000000000000000000000000000111111110000000
00000000000000000000000000000000000011111100000000
00000000000000000000000000000000000000110000000001
00000000000000000000000000000000000000000000000011
00000000000000000000000000000000000000000000001111
00000000000000000000000000000000000000000000011111
00000000000000000000000000000000000000000000111111
00000000000000000000000000000000000000000011111111
11111111110000000000000000000000000000000011111111
11111111110000000000000000000000000000000011111111
11111111111111111111111111111111111111111111111111
11111111111111111111111111111111111111111111111111
11111111111111111111111111111111111111111111111111
11111111111111111111111111111111111111111111111111
11111111111111111111111111111111111111111111111111
11111111111111111111111111111111111111111111111111
11111111111111111111111111111111111111111111111111